10 4 4 16 4 4 4 16 4 4 11 3 3 10 4 16 4 4 4 16 4 11 3 3 3 3 3 3 3 3 10 4 4 4 16 4 4 4 16 4 4 4 16 4 4 4 11 3 3 3
6 33 0 0 0 0 0 0 0 33 7 3 3 6 32 32 32 0 0 32 32 7 3 3 3 3 3 3 3 3 6 32 32 32 32 0 0 0 0 0 0 0 0 32 32 32 7 3 3 3
6 0 0 23 20 20 20 24 0 0 7 3 3 6 32 32 0 0 0 32 32 19 3 3 3 3 3 3 3 3 6 32 32 0 0 0 0 0 0 0 32 32 32 32 32 0 7 3 3 3
18 0 0 21 0 37 0 22 0 0 15 4 4 14 0 0 0 0 0 0 32 7 3 3 3 3 3 3 3 3 18 32 0 0 0 0 0 0 0 0 0 32 32 32 32 0 19 3 3 3
6 0 0 21 0 0 0 22 0 0 0 0 0 0 0 0 0 0 0 0 0 7 3 3 3 3 3 3 3 3 6 32 0 0 33 0 0 0 0 0 0 0 0 32 32 0 7 3 3 3
6 0 0 25 27 31 28 26 0 0 0 0 0 0 0 0 0 0 0 0 32 19 3 3 3 3 3 3 3 3 6 0 0 0 0 0 0 0 0 0 0 0 0 0 0 0 7 3 3 3
6 0 0 0 29 31 30 0 0 0 0 0 0 0 0 0 0 0 32 32 32 7 3 3 3 3 3 3 3 3 18 0 0 0 0 0 0 0 0 0 0 0 0 33 0 0 19 3 3 3
18 0 0 0 0 0 0 0 0 0 13 5 5 12 0 0 0 13 5 5 5 9 3 3 3 3 3 3 3 3 6 0 0 0 0 0 0 0 0 0 0 0 0 0 0 0 7 3 3 3
6 0 0 0 0 0 0 0 0 0 7 3 3 6 0 0 0 7 3 3 3 3 3 3 3 3 3 3 3 3 6 0 0 33 0 0 0 0 0 0 0 0 0 0 32 32 7 3 3 3
6 33 0 0 0 0 0 0 0 33 7 3 3 6 0 0 0 7 3 3 3 3 3 3 3 3 3 3 3 3 18 0 0 0 0 0 0 0 0 0 0 0 0 32 32 32 19 3 3 3
8 5 5 12 0 0 0 13 5 5 9 3 3 18 0 0 0 19 3 3 3 3 3 3 3 3 3 3 3 3 6 0 0 32 32 0 0 0 0 0 33 0 0 0 32 32 7 3 3 3
3 3 3 6 0 0 32 7 3 3 3 3 3 6 0 0 0 7 3 3 3 3 3 3 3 3 3 3 3 3 6 32 32 32 32 32 0 0 0 0 0 0 0 0 0 32 7 3 3 3
3 3 3 6 0 0 32 7 3 3 3 3 3 6 0 0 0 7 3 3 3 3 3 3 3 3 3 3 3 3 8 5 5 17 5 5 12 0 0 0 13 5 5 17 5 5 9 3 3 3
3 3 3 6 0 0 0 7 3 3 3 3 10 14 0 0 0 15 4 4 4 4 16 4 4 4 4 11 3 3 3 3 3 3 3 3 6 0 0 0 7 3 3 3 3 3 3 3 3 3
3 3 3 18 0 0 0 19 3 3 3 3 6 0 0 0 0 0 0 0 32 0 0 0 0 0 33 15 4 4 4 16 4 4 4 4 14 0 0 0 15 4 4 4 16 4 4 4 4 11
3 3 3 6 32 0 0 7 3 3 3 3 6 0 0 0 0 0 0 0 0 0 0 0 0 0 0 0 0 0 0 0 0 32 32 0 33 0 0 0 33 0 0 0 0 0 32 32 32 7
3 3 3 6 32 0 0 7 3 3 3 3 6 0 0 0 0 0 0 0 0 0 0 0 0 0 0 0 0 0 0 0 0 0 0 0 0 0 0 0 0 0 0 0 0 0 0 32 32 7
3 3 3 6 0 0 0 7 3 3 3 3 18 0 0 0 13 5 5 17 5 5 12 32 0 0 0 0 0 0 0 0 0 0 0 0 0 0 0 0 0 0 0 0 0 0 0 0 0 19
3 3 3 18 0 0 0 19 3 3 3 3 6 0 0 0 7 3 3 3 3 3 6 32 32 0 0 0 0 0 0 0 0 0 0 0 0 0 0 0 32 32 0 0 0 0 0 0 0 7
3 3 3 6 0 0 0 7 3 3 3 3 6 0 0 0 7 3 3 3 3 3 8 5 5 5 5 17 5 5 5 12 0 0 13 5 5 5 17 5 5 5 5 12 0 0 0 0 0 7
3 3 3 6 0 0 32 7 3 3 3 3 6 32 0 0 19 3 3 3 3 3 3 3 3 3 3 3 3 3 3 6 0 0 7 3 3 3 3 3 3 3 3 6 0 0 0 0 0 7
3 3 3 6 0 0 32 7 3 3 3 3 6 32 0 0 7 3 3 3 3 3 3 3 3 3 3 3 3 3 3 6 0 0 7 3 3 3 3 3 3 3 3 18 0 0 0 0 0 19
3 3 3 6 0 0 0 7 3 3 3 3 18 0 0 0 7 3 3 3 3 3 3 3 3 10 4 4 16 4 4 14 0 0 15 4 4 16 4 4 11 3 3 6 0 0 0 0 0 7
10 4 4 14 0 0 0 19 3 3 3 3 6 0 0 0 7 3 3 3 3 3 3 3 3 6 33 0 0 0 0 0 0 0 0 0 32 0 0 33 7 3 3 6 0 0 0 0 0 7
6 32 32 0 0 0 0 7 3 3 3 3 6 0 0 0 7 3 3 3 3 3 3 3 3 6 0 0 0 0 0 0 0 0 0 32 32 0 0 0 7 3 3 6 33 0 0 0 0 7
6 32 0 0 0 0 0 7 3 3 3 3 6 0 0 0 15 4 16 4 4 4 4 16 4 14 0 0 0 0 32 32 0 0 0 0 0 0 0 0 7 3 3 8 5 5 12 0 0 19
18 32 0 0 0 0 33 7 3 3 3 3 6 0 0 0 0 0 0 0 0 0 0 0 0 0 0 0 0 0 23 20 20 20 24 0 0 0 0 0 19 3 3 3 3 3 6 0 0 7
6 0 0 0 13 5 5 9 3 3 3 3 18 0 0 0 0 0 32 32 0 0 0 0 0 0 0 0 0 0 21 0 37 0 22 0 0 32 0 0 7 3 3 3 3 3 6 0 0 7
6 0 0 0 7 3 3 3 3 3 3 3 6 0 0 0 13 5 5 5 5 5 5 12 0 0 0 32 0 0 21 0 0 0 22 0 0 32 32 0 7 3 3 3 3 3 6 0 0 7
6 0 0 0 7 3 3 3 3 3 3 3 6 0 0 0 7 3 3 3 3 3 3 6 0 0 32 32 0 0 25 27 31 28 26 0 0 32 32 0 7 3 3 3 3 3 18 0 0 19
6 0 0 0 7 3 3 3 3 3 3 3 6 0 0 0 7 3 3 3 3 3 3 18 0 0 32 32 0 0 0 29 31 30 0 0 0 0 0 0 15 4 4 4 11 3 6 0 0 7
6 0 0 0 15 4 16 4 4 4 16 4 14 0 0 0 15 4 16 4 4 11 3 6 0 0 0 0 0 0 0 0 0 0 0 0 0 0 0 0 0 0 32 32 7 3 6 0 0 7
6 0 0 0 0 0 0 0 0 0 0 0 0 0 0 0 0 0 0 0 33 7 3 6 0 0 0 0 0 0 0 0 0 0 0 32 32 32 0 0 0 0 33 32 7 3 6 0 0 7
18 0 0 0 0 0 0 0 0 0 0 0 0 0 0 32 0 0 0 0 0 19 3 6 0 0 0 0 0 0 0 13 5 17 5 5 5 17 5 12 0 0 0 0 15 4 14 0 0 19
6 0 0 0 13 5 5 5 5 12 0 0 0 32 32 32 32 0 0 0 0 7 3 6 0 0 0 0 0 0 33 7 3 3 3 3 3 3 3 6 0 0 0 0 0 0 0 0 0 7
6 32 0 0 7 3 3 3 3 6 0 0 0 0 32 32 0 0 0 0 0 7 3 18 0 0 0 0 13 5 5 9 3 3 3 3 3 10 4 14 0 0 0 0 0 0 0 0 0 7
6 32 0 0 7 3 3 3 3 6 0 0 0 0 0 0 0 0 0 0 0 19 3 6 0 0 0 0 7 3 3 3 3 3 3 3 3 6 32 32 0 0 0 0 0 0 0 0 33 7
6 32 0 0 7 3 3 3 3 6 33 0 0 0 0 0 0 0 0 0 33 7 3 6 32 0 0 0 7 3 3 3 3 3 3 3 3 6 32 0 0 0 13 5 5 5 5 5 5 9
6 0 0 0 7 3 3 3 3 8 5 5 12 0 0 0 13 5 17 5 5 9 3 6 32 0 0 0 15 4 16 4 4 4 4 16 4 14 0 0 0 0 7 3 3 3 3 3 3 3
18 0 0 0 15 4 11 3 3 3 3 3 6 0 0 0 7 3 3 3 3 3 3 6 0 0 0 0 0 0 0 0 0 0 0 0 0 0 0 0 0 0 7 3 3 3 3 3 3 3
6 0 0 0 32 32 7 3 3 3 3 3 6 0 0 0 7 3 3 3 3 3 3 18 0 0 0 0 0 0 0 0 0 0 0 0 0 0 0 0 0 0 7 3 3 3 3 3 3 3
6 0 0 0 0 32 7 3 3 3 3 3 6 0 0 0 19 3 3 3 3 3 3 6 33 0 0 0 0 0 0 0 0 0 0 0 0 0 0 0 0 33 7 3 3 3 3 3 3 3
6 0 0 0 0 0 15 4 4 16 4 4 14 0 0 0 7 3 3 3 3 3 3 8 5 5 5 17 5 5 5 12 0 0 13 5 5 5 17 5 5 5 9 3 3 3 3 3 3 3
18 0 0 0 0 0 0 0 0 0 0 0 0 0 0 32 7 3 3 3 3 3 3 3 3 3 3 3 3 3 3 6 0 0 7 3 3 3 3 3 3 3 3 3 3 3 3 3 3 3
6 0 0 0 0 0 0 0 0 0 0 0 0 0 0 32 7 3 3 3 3 3 3 3 3 3 3 3 3 3 3 6 0 0 7 3 3 3 3 3 3 3 3 3 3 3 3 3 3 3
6 33 0 0 0 0 0 0 0 0 0 0 0 0 0 0 7 3 3 3 3 3 3 3 3 3 3 10 4 4 4 14 0 0 15 4 4 4 11 3 3 3 3 3 3 3 3 3 3 3
8 5 5 17 5 5 12 0 0 0 0 0 0 0 0 0 19 3 3 3 3 3 3 3 3 3 3 6 0 32 0 0 0 0 0 0 0 0 7 3 3 3 3 3 3 3 3 3 3 3
3 3 3 3 3 3 6 0 0 0 0 0 0 0 0 0 7 3 3 3 3 3 3 3 3 3 3 18 0 0 0 0 0 0 0 0 0 0 19 3 3 3 3 3 3 3 3 3 3 3
3 3 3 3 3 3 6 33 0 0 0 0 0 0 0 33 7 3 3 3 3 3 3 3 3 3 3 6 33 0 0 0 0 0 32 0 0 33 7 3 3 3 3 3 3 3 3 3 3 3
3 3 3 3 3 3 8 5 5 17 5 5 5 17 5 5 9 3 3 3 3 3 3 3 3 3 3 8 5 17 5 5 5 5 5 5 17 5 9 3 3 3 3 3 3 3 3 3 3 3