10 4 4 16 4 4 4 16 4 4 11 3 3 10 4 16 4 4 4 16 4 11 3 3 3 3 3 3 3 3 10 4 4 4 16 4 4 4 16 4 4 4 16 4 4 4 11 3 3 3
6 0 0 0 0 0 0 0 0 0 7 3 3 6 0 0 0 0 0 0 0 7 3 3 3 3 3 3 3 3 6 0 0 0 0 0 0 0 0 0 0 0 0 0 0 0 7 3 3 3
6 0 0 0 0 0 0 0 0 0 7 3 3 6 0 0 0 0 0 0 0 19 3 3 3 3 3 3 3 3 6 0 0 0 0 0 0 0 0 0 0 0 0 0 0 0 7 3 3 3
18 0 0 0 0 0 0 0 0 0 15 4 4 14 0 0 0 0 0 0 0 7 3 3 3 3 3 3 3 3 18 0 0 0 0 0 0 0 0 0 0 0 0 0 0 0 19 3 3 3
6 0 0 0 0 0 0 0 0 0 0 0 0 0 0 0 0 0 0 0 0 7 3 3 3 3 3 3 3 3 6 0 0 0 0 0 0 0 0 0 0 0 0 0 0 0 7 3 3 3
6 0 0 0 0 0 0 0 0 0 0 0 0 0 0 0 0 0 0 0 0 19 3 3 3 3 3 3 3 3 6 0 0 0 0 0 0 0 0 0 0 0 0 0 0 0 7 3 3 3
6 0 0 0 0 0 0 0 0 0 0 0 0 0 0 0 0 0 0 0 0 7 3 3 3 3 3 3 3 3 18 0 0 0 0 0 0 0 0 0 0 0 0 0 0 0 19 3 3 3
18 0 0 0 0 0 0 0 0 0 13 5 5 12 0 0 0 13 5 5 5 9 3 3 3 3 3 3 3 3 6 0 0 0 0 0 0 0 0 0 0 0 0 0 0 0 7 3 3 3
6 0 0 0 0 0 0 0 0 0 7 3 3 6 0 0 0 7 3 3 3 3 3 3 3 3 3 3 3 3 6 0 0 0 0 0 0 0 0 0 0 0 0 0 0 0 7 3 3 3
6 0 0 0 0 0 0 0 0 0 7 3 3 6 0 0 0 7 3 3 3 3 3 3 3 3 3 3 3 3 18 0 0 0 0 0 0 0 0 0 0 0 0 0 0 0 19 3 3 3
8 5 5 12 0 0 0 13 5 5 9 3 3 18 0 0 0 19 3 3 3 3 3 3 3 3 3 3 3 3 6 0 0 0 0 0 0 0 0 0 0 0 0 0 0 0 7 3 3 3
3 3 3 6 0 0 0 7 3 3 3 3 3 6 0 0 0 7 3 3 3 3 3 3 3 3 3 3 3 3 6 0 0 0 0 0 0 0 0 0 0 0 0 0 0 0 7 3 3 3
3 3 3 6 0 0 0 7 3 3 3 3 3 6 0 0 0 7 3 3 3 3 3 3 3 3 3 3 3 3 8 5 5 17 5 5 12 0 0 0 13 5 5 17 5 5 9 3 3 3
3 3 3 6 0 0 0 7 3 3 3 3 10 14 0 0 0 15 4 4 4 4 16 4 4 4 4 11 3 3 3 3 3 3 3 3 6 0 0 0 7 3 3 3 3 3 3 3 3 3
3 3 3 18 0 0 0 19 3 3 3 3 6 0 0 0 0 0 0 0 0 0 0 0 0 0 0 15 4 4 4 16 4 4 4 4 14 0 0 0 15 4 4 4 16 4 4 4 4 11
3 3 3 6 0 0 0 7 3 3 3 3 6 0 0 0 0 0 0 0 0 0 0 0 0 0 0 0 0 0 0 0 0 0 0 0 0 0 0 0 0 0 0 0 0 0 0 0 0 7
3 3 3 6 0 0 0 7 3 3 3 3 6 0 0 0 0 0 0 0 0 0 0 0 0 0 0 0 0 0 0 0 0 0 0 0 0 0 0 0 0 0 0 0 0 0 0 0 0 7
3 3 3 6 0 0 0 7 3 3 3 3 18 0 0 0 13 5 5 17 5 5 12 0 0 0 0 0 0 0 0 0 0 0 0 0 0 0 0 0 0 0 0 0 0 0 0 0 0 19
3 3 3 18 0 0 0 19 3 3 3 3 6 0 0 0 7 3 3 3 3 3 6 0 0 0 0 0 0 0 0 0 0 0 0 0 0 0 0 0 0 0 0 0 0 0 0 0 0 7
3 3 3 6 0 0 0 7 3 3 3 3 6 0 0 0 7 3 3 3 3 3 8 5 5 5 5 17 5 5 5 12 0 0 13 5 5 5 17 5 5 5 5 12 0 0 0 0 0 7
3 3 3 6 0 0 0 7 3 3 3 3 6 0 0 0 19 3 3 3 3 3 3 3 3 3 3 3 3 3 3 6 0 0 7 3 3 3 3 3 3 3 3 6 0 0 0 0 0 7
3 3 3 6 0 0 0 7 3 3 3 3 6 0 0 0 7 3 3 3 3 3 3 3 3 3 3 3 3 3 3 6 0 0 7 3 3 3 3 3 3 3 3 18 0 0 0 0 0 19
3 3 3 6 0 0 0 7 3 3 3 3 18 0 0 0 7 3 3 3 3 3 3 3 3 10 4 4 16 4 4 14 0 0 15 4 4 16 4 4 11 3 3 6 0 0 0 0 0 7
10 4 4 14 0 0 0 19 3 3 3 3 6 0 0 0 7 3 3 3 3 3 3 3 3 6 0 0 0 0 0 0 0 0 0 0 0 0 0 0 7 3 3 6 0 0 0 0 0 7
6 0 0 0 0 0 0 7 3 3 3 3 6 0 0 0 7 3 3 3 3 3 3 3 3 6 0 0 0 0 0 0 0 0 0 0 0 0 0 0 7 3 3 6 0 0 0 0 0 7
6 0 0 0 0 0 0 7 3 3 3 3 6 0 0 0 15 4 16 4 4 4 4 16 4 14 0 0 0 0 0 0 0 0 0 0 0 0 0 0 7 3 3 8 5 5 12 0 0 19
18 0 0 0 0 0 0 7 3 3 3 3 6 0 0 0 0 0 0 0 0 0 0 0 0 0 0 0 0 0 0 0 0 0 0 0 0 0 0 0 19 3 3 3 3 3 6 0 0 7
6 0 0 0 13 5 5 9 3 3 3 3 18 0 0 0 0 0 0 0 0 0 0 0 0 0 0 0 0 0 0 0 0 0 0 0 0 0 0 0 7 3 3 3 3 3 6 0 0 7
6 0 0 0 7 3 3 3 3 3 3 3 6 0 0 0 13 5 5 5 5 5 5 12 0 0 0 0 0 0 0 0 0 0 0 0 0 0 0 0 7 3 3 3 3 3 6 0 0 7
6 0 0 0 7 3 3 3 3 3 3 3 6 0 0 0 7 3 3 3 3 3 3 6 0 0 0 0 0 0 0 0 0 0 0 0 0 0 0 0 7 3 3 3 3 3 18 0 0 19
6 0 0 0 7 3 16 3 3 3 16 3 6 0 0 0 7 3 3 3 3 3 3 18 0 0 0 0 0 0 0 0 0 0 0 0 0 0 0 0 15 4 4 4 11 3 6 0 0 7
6 0 0 0 15 4 4 4 4 4 4 4 14 0 0 0 15 4 16 4 4 11 3 6 0 0 0 0 0 0 0 0 0 0 0 0 0 0 0 0 0 0 0 0 7 3 6 0 0 7
6 0 0 0 0 0 0 0 0 0 0 0 0 0 0 0 0 0 0 0 0 7 3 6 0 0 0 0 0 0 0 0 0 0 0 0 0 0 0 0 0 0 0 0 7 3 6 0 0 7
18 0 0 0 0 0 0 0 0 0 0 0 0 0 0 0 0 0 0 0 0 19 3 6 0 0 0 0 0 0 0 13 5 17 5 5 5 17 5 12 0 0 0 0 15 4 14 0 0 19
6 0 0 0 13 5 5 5 5 12 0 0 0 0 0 0 0 0 0 0 0 7 3 6 0 0 0 0 0 0 0 7 3 3 3 3 3 3 3 6 0 0 0 0 0 0 0 0 0 7
6 0 0 0 7 3 3 3 3 6 0 0 0 0 0 0 0 0 0 0 0 7 3 18 0 0 0 0 13 5 5 9 3 3 3 3 3 10 4 14 0 0 0 0 0 0 0 0 0 7
6 0 0 0 7 3 3 3 3 6 0 0 0 0 0 0 0 0 0 0 0 19 3 6 0 0 0 0 7 3 3 3 3 3 3 3 3 6 0 0 0 0 0 0 0 0 0 0 0 7
6 0 0 0 7 3 3 3 3 6 0 0 0 0 0 0 0 0 0 0 0 7 3 6 0 0 0 0 7 3 3 3 3 3 3 3 3 6 0 0 0 0 13 5 5 5 5 5 5 9
6 0 0 0 7 3 3 3 3 8 5 5 12 0 0 0 13 5 17 5 5 9 3 6 0 0 0 0 15 4 16 4 4 4 4 16 4 14 0 0 0 0 7 3 3 3 3 3 3 3
18 0 0 0 15 4 11 3 3 3 3 3 6 0 0 0 7 3 3 3 3 3 3 6 0 0 0 0 0 0 0 0 0 0 0 0 0 0 0 0 0 0 7 3 3 3 3 3 3 3
6 0 0 0 0 0 7 3 3 3 3 3 6 0 0 0 7 3 3 3 3 3 3 18 0 0 0 0 0 0 0 0 0 0 0 0 0 0 0 0 0 0 7 3 3 3 3 3 3 3
6 0 0 0 0 0 7 3 3 3 3 3 6 0 0 0 19 3 3 3 3 3 3 6 0 0 0 0 0 0 0 0 0 0 0 0 0 0 0 0 0 0 7 3 3 3 3 3 3 3
6 0 0 0 0 0 15 4 4 16 4 4 14 0 0 0 7 3 3 3 3 3 3 8 5 5 5 17 5 5 5 12 0 0 13 5 5 5 17 5 5 5 9 3 3 3 3 3 3 3
18 0 0 0 0 0 0 0 0 0 0 0 0 0 0 0 7 3 3 3 3 3 3 3 3 3 3 3 3 3 3 6 0 0 7 3 3 3 3 3 3 3 3 3 3 3 3 3 3 3
6 0 0 0 0 0 0 0 0 0 0 0 0 0 0 0 7 3 3 3 3 3 3 3 3 3 3 3 3 3 3 6 0 0 7 3 3 3 3 3 3 3 3 3 3 3 3 3 3 3
6 0 0 0 0 0 0 0 0 0 0 0 0 0 0 0 7 3 3 3 3 3 3 3 3 3 3 10 4 4 4 14 0 0 15 4 4 4 11 3 3 3 3 3 3 3 3 3 3 3
8 5 5 17 5 5 12 0 0 0 0 0 0 0 0 0 19 3 3 3 3 3 3 3 3 3 3 6 0 0 0 0 0 0 0 0 0 0 7 3 3 3 3 3 3 3 3 3 3 3
3 3 3 3 3 3 6 0 0 0 0 0 0 0 0 0 7 3 3 3 3 3 3 3 3 3 3 18 0 0 0 0 0 0 0 0 0 0 19 3 3 3 3 3 3 3 3 3 3 3
3 3 3 3 3 3 6 0 0 0 0 0 0 0 0 0 7 3 3 3 3 3 3 3 3 3 3 6 0 0 0 0 0 0 0 0 0 0 7 3 3 3 3 3 3 3 3 3 3 3
3 3 3 3 3 3 8 5 5 17 5 5 5 17 5 5 9 3 3 3 3 3 3 3 3 3 3 8 5 17 5 5 5 5 5 5 17 5 9 3 3 3 3 3 3 3 3 3 3 3